NO textures/wolfenstein/grey_stone.xpm
SO textures/wolfenstein/purple_stone.xpm
WE textures/wolfenstein/red_brick.xpm
EA textures/wolfenstein/wood.xpm

F 220,100,0
C 225,30,0

        1111111111111111111111111
        1000000000110000000000001
        1011000001110000000000001
        1001000000000000000000001
111111111011000001110000000000001
100000000011000001110111111101111
11110111111111011100000010001
111101111111110111010100100011111111
110000001101010111000000000000000001
100000000000000011000000100000000001
100000000000000011010100100000000001
11000001110101011111011110N011111111
11110111 1110101 101111010001
11111111 1111111 111111111111
