NO textures/wolfenstein/grey_stone.xpm
SO textures/wolfenstein/purple_stone.xpm
WE textures/wolfenstein/red_brick.xpm
EA textures/wolfenstein/wood.xpm

F 220,100,0
C 225,30,0

        1111111111111111111111111
        1000000000110000000000001
        1011000001110000000000001
        1001000000000000000000001
111111111011000001110000000000001
100000000011000001111111111111111
11110111011111011100000010001         111111
11110000011111011101010010001         1000011
11000111110101011100000000001111111111101111
10000000000000000000000010000000000000001
10000000000000001101010010001111111111111
11000001110101011111011110N01
11110111 1110101 101111010001
11111111 1111111 111111111111
