NO textures/bonus/ai4m.xpm
SO textures/bonus/ai4.xpm
WE textures/bonus/ai4m.xpm
EA textures/bonus/ai4.xpm

F 222, 192, 145
C 219, 208, 186

11111111111111111111111111111111111111111111
100B00000B0000B00001000000000000B00001000001
100000001111110000000000000B0000000000000111
10000000100000000001111111111111111111000001
1011111110001111000000000B000000000000000001
10100000000010010111111111111111110010010B01
1010B00N000010010100000000000000010010010001
1011111110B000B10100000B00000000010010010001
10000B00000010000100000000000000000011111111
10111111100010010100010111111111010000000001
1000B0000000100101000100000B00000100000B0001
11111111111111111111111111111111111111111111
