NO textures/bonus/ai4m.xpm
SO textures/bonus/ai4.xpm
WE textures/bonus/ai4m.xpm
EA textures/bonus/ai4.xpm

F 20,20,20
C 219, 208, 186

111111111111111111111111111111111111111111
1E0B00000B0000B000011111111111110000000001
1B00B00B111111000000000000000000000000000111
10111110111000010001111111111111111111000101
10111111000110100000000000000000000100101001
10100000000011010111111111111111111010010101
10100000000011010100000000000000011010010101
10111110000000010101111111111111011010010001
10000000001111010101000000000000011011111111
10111111100010000101010111111111000000000001
10000000000011110101010000000000000001111111
11111111111111111111111111111111111111111111
